

    __  ____                    _____           _         
   /  |/  (_)_____________     / ___/___  _____(_)_______ 
  / /|_/ / / ___/ ___/ __ \    \__ \/ _ \/ ___/ / ___/ _ \
 / /  / / / /__/ /  / /_/ /   ___/ /  __/ /  / / /__/  __/
/_/  /_/_/\___/_/   \____/   /____/\___/_/  /_/\___/\___/ 
                                                          
${application.version}
${spring-boot.version}
${application.title}